10 10
XXXPXXXPXX
EPXPPPXPXX
XPXPXPPPXX
PPXPXXXPXX
XPPPPXXXXX
XPXXPPXPXX
XPPPXPXPXX
XXXPXPPPXX
PPXPXXXPPP
XPPPXXXSXX
