10 10
XXXPPPPPXX
EPPPPPXPXX
XXXPXPPPXX
PPXXXXXPXX
XPPPPXXPXX
XPXXPPXPXX
XPPPXPXPXX
XXXPXPPPXX
PPXPXXXPPP
XPPPXXXSXX
